9 15 1 0 -14 1
***************
              *
***************
*             *
* *************
*             *
************* *
*             *
* *************
