7 15 0 7 3 7
******* *******
*             *
*      *      *
*     * *     *
*      *      *
*             *
***************
