9 45 1 0 7 44
*********************************************
          *     *     *               ****  *
* *    *  *     *     *    *    *    *    * *
* *    *   *   * *   *   **********      *  *
* ******   *   * *   *     *    *       *   *
* *    *    * *   * *      *    *      *    *
* *    *    * *   * *    **********   ***** *
* *    *                   *    *            
*********************************************
